# # # # # # # # # # # # #
# U !   Z       Z       #
# # # # # # # # # # #   #
# a d         Y K K # R #
# # # # # # # # h h #   #
#             Y     # K #
# # # # Y #   # y b # Z #
# b B K   #   # # # #   #
# b # K   # Z   y       #
# # # Y # #   # # # # Y #
# r # K y #   # a y Z K #
# r Y K y #   # d y Z K #
# # # # # # @ # # # # # #