# # # # # # # # # # # # #
# U !   Z       Z       #
# # # # # # # # # # #   #
#             # Z Z # R #
# # # Y # # # # h h #   #
#             Y     # K #
# # # # Y #   #   b # Z #
# b B     #   # # # #   #
# b #     # Z   y       #
# # # Y # #   # # # # Y #
# r # y Z #   # a a Z K #
# r Y y Z #   # d d y y #
# # # # # # @ # # # # # #