#############
#D@    Z    #
########### #
#bbK# #Kaa# #
#yyKY YKdd#Y#
#####Z##### #
#       Z   #
# ##Y##Y#B#R#
#K#ZZZ#K#K#Z#
#K#ZHZ#d#a#T#
#K###########
#  h B  F !U#
#############