#############
#U!.E.#.E.!U#
#####B#B#####
#a.F..H..F.d#
#.#.#####.#.#
#h.EYBSBYE.h#
#.#.#####.#.#
#y.F..a..F.b#
#####Y#Y#####
#y.W.....W..#
#.####.####.#
#..FW...WF@D#
#############
