#############
#D@.F...F.h.#
###########.#
#.K.Y.S.Y.K.#
#.#.#####.#.#
#H#..F..#.a.#
#.#######.#.#
#.....W.....#
#.####.####.#
#.#..d..#.b.#
#.#######.#.#
#.F...y...!U#
#############
