#############
#D@.W...W.h.#
###########.#
#.F.B.H.Y.F.#
#.#.#####.#.#
#.#.W.a.#.d.#
#.#######.#.#
#.....E.....#
#.####Y####.#
#.#..a..#.b.#
#.#######.#.#
#.W...y...!U#
#############
