#############
#D@.W.#.W.@D#
#####W#W#####
#brER.#.RErb#
#####W#W#####
#CPC#.#.#yQy#
#ECE#R#R#ryr#
#rhb#.#.#brb#
#Y###E#C#aba#
#EBy#.#.Bdad#
#.###.#.#####
#E.E.E#C.C!U#
#############