#############
#D@.W.#.W.@D#
#####W#W#####
#brER.#.RErb#
#####W#W#####
#CPC#.#.#.d.#
#ECE#R#R#...#
#dhd#.#.#...#
#Y###E#C###.#
#EBy#.#.#bb.#
#.###.#.#####
#E.E.E#C.C!U#
#############
