#############
#D@.E.....H.#
#.####.####.#
#.W...Y...a.#
#.####.####.#
#.E.......d.#
#.####.######
#...........#
#.#########.#
#...........#
#.#########.#
#.W...y...!U#
#############
