#############
#.FJCEWECJF.#
#.####R####.#
#dYJH#R#HJYd#
#.####R####.#
#aBJh#R#hJBa#
#.####R####.#
#dRCd#L#dCRd#
#.#########.#
#aYCa#U#aCYa#
#.####B####@#
#.FJCEWECJFD#
#############
