#############
#.....#.....#
#...##.##...#
#.##..M..##.#
##...MXM...##
#.#...M...#.#
#...........#
#...JJJJJ...#
#...J.@.J...#
#...J.D.J...#
#...JJJJJ...#
#...........#
#############
